"###############################################################################################################################################"
"#                           w                           w                                                     w                               #"
"@                     w                        w                                                              w  E                            #"
"#                          w                           w                                                                                      #"
"###############################################################################################################################################"